#######################
#          G          #
#######################
#   #......P......#   #
#######################
#                     #
#        # #          #
#        ###          #
#          #          #
#          #          #
#                     #
#######################