#######################
#          G          #
#######################
#   #......P......#   #
#######################
#                     #
#         ##          #
#        # #          #
#         #           #
#        ###          #
#                     #
#######################