#######################
#          G          #
#######################
#   #......P......#   #
#######################
#                     #
#        ##           #
#          #          #
#        ##           #
#          #          #
#        ##           #
#                     #
#######################